Rank,Team,Gold,Silver,Bronze,Total,Rank_by_Total
1,China,14,6,9,29,2
2,USA,13,13,10,36,1
3,Japan,13,4,5,22,4
4,ROC,7,11,7,25,3
5,Australia,7,2,10,19,5
6,Great Britain,5,6,5,16,7
7,Korea,4,2,5,11,9
8,Germany,3,3,5,11,9
9,France,3,3,3,9,12
10,Italy,2,7,9,18,6